-------------------------------------------
|                                         |
|                                         |
|     --------------------------------    |
|     |                              |    |
|     ------                         |    |
|          |                              |
|          |                              |
|          |                              |
|  ---------                              |
|  |                                      |
|  ----                                   |
|     |                                   |
|     |                                   |
-------------------------------------------
