-------------------------------------------
|                            |            |
|                            | |  --------|
|---------------     ----    | |  |       |
|              |     |       | |  |       |
|              |     |       | ---|   ----|
|    -----     |     |       |    |   |   |
|    |         |     ---------    |   |   |
|    |                                |   |
|    ----           ------            |   |
|  |    ---------   |    |    ---------   |
|  ---  |           |    |    |           |
|    |  |      -------   |    ----------  |
|    |  |                |                |
-------------------------------------------